11111111111111111111111111111111
10000000000000000000100010001001
10101111111101011100001000100001
10100010000101000011111111111101
101110100001010000000C0000000001
1P1000100001E0111111011111111101
10100000000100000000010000000001
11111111111111111111111111111111